#.############################
#................#############
################.............#
#...##.....# #...............#
##.###.....# #.###############
##.# #.....# #...............#
##.#####.###################.#
##.##.........#       #...##.#
##.##########.#       #.#.##.#
##.######## #.#       #.#.##.#
#.........# #.######  #.#.##.#
#.......#.# #......####.#....#
#.......#.# #.####......######
#########.# #.#  #############
#.........# #.#     #........#
#.###########.#######.########
#.#  #................#  #...#
#.#  ################.#  ###.#
#.###################.######.#
#............................#
##############.###############
                              
                              
                              