                              
##########       #############
.........#       #..........# 
 #.......#  ######.########.# 
 #.......#  #......########.##
 #.......#  #......##....#...#
 ####.#######......##....#...#
    #..............##........#
    ######.##########....#...#
     #####.####...###....#...#
     #..........#.#####.######
     ##########...#   #.#     
             ##########.#     
########     #..........#     
#......#     #......#####     
#......#     #......#         
#......#######......#         
#...................#         
#......##############         
########                      