##############################
#     #..............# #######
#     #..............# #......
#     #..............###....##
#     #.....................##
#     #..............#########
#######..............#      ##
##...................#      ##
##.###################      ##
##.#######.....###############
##.........###..............##
##.........# #..............##
##.........# #..............##
############ ##############.##
#    ########             #.##
######......#   ###########.##
#...........#   #...........##
######......#####..........###
#    #.....................# #
##############################
                              
                              
                              