################  ###.########
#       ######.#  #......#   #
#########......#  #......#   #
#.........##############.##  #
#.........# #.............#  #
#.........# #....###......#  #
#.........#########.......#  #
##.###.##...........#.....#  #
##.###.#######.######.#####  #
##.....#     #.#    #.#####  #
##.....#     ###    #....#####
################    ####....##
# #............#    ####....##
# #.........##.######.......##
# #.........##..............##
# #.........##############.###
# #.##########     #######.###
###..........#     #.......###
#...###......#     #.......###
##############################
                              
                              
                              