             ###  ###.####    
        ######.#  #......#    
#########......#  #......#    
#.........##############.##   
#.........# #.............#   
#.........# #....###......#   
#.........#########.......#   
##.###.##...........#.....#   
 #.###.#######.######.#####   
 #.....#     #.#    #.#####   
 #.....#     ###    #....#### 
 ###############    ####....# 
  #............#    ####....# 
  #.........##.######.......# 
  #.........##..............# 
  #.........##############.## 
  #.##########     #######.## 
###..........#     #.......## 
#...###......#     #.......## 
#.### #######      ########## 
                              
                              
                              