      ################        
      #..............# #######
      #..............# #......
      #..............###....##
      #.....................# 
      #..............######## 
 ######..............#      # 
 #...................#      # 
 #.###################      # 
 #.#######.....############## 
 #.........###..............# 
 #.........# #..............# 
 #.........# #..............# 
 ########### ##############.# 
     ########             #.# 
     #......#   ###########.# 
     #......#   #...........# 
     #......#####..........## 
     #.....................#  
     #########.#############  