##############################
##.......#       #..........##
#........#       #..........##
##.......#  ######.########.##
##.......#  #......########.##
##.......#  #......##....#...#
#####.#######......##....#...#
#   #..............##........#
#   ######.##########....#...#
#    #####.####...###....#...#
#    #..........#.#####.######
#    ##########...#   #.#    #
#            ##########.#    #
########     #..........#    #
#......#     #......#####    #
#......#     #......#        #
#......#######......#        #
#...................#        #
#......#######.######        #
##############.###############
                              
                              
                              