################################################################
#  #.......#################....................#              #
####............................................#              #
..................##########..################..################
######..########..#        #..#              #.................#
######..#      #..#        #..#              #.................#
#...##..#      #..##########..#     ##########.#################
#.......#      #..............#     #..........#               #
#...#####      #..............#     #..........#         #######
################..######..#####     ############         #.....#
#.................#    #..################################.....#
#.................#    #.......................................#
###################    #.......................................#
########################..############################..##.....#
##........................#     #...................##..########
######....................#     #...................##..#      #
##...........##############     #...................##..#      #
######.......#   #######        #..###################..#      #
##...........#   #.....#  #######..#   #................########
######..######   #.....#  #........#   #..#################...##
#    #..#        #.....#  #........#   #..#################...##
#    #..##########.....####..###########......................##
#    #........................................................##
#    #....................................#################...##
#    ####..################..###########..#################...##
#########..#              #..#         #......................##
#..........#           ####..#         #......................##
#..........# ###########.....#         ########..###############
#......##..# #...............##################..###############
#......##..# #.....########...................................##
#########..# #.....#      #...................................##
#......##..# #.....########..########.#########.#########.######
#......##..# #...............#    #.....#   #.....#   #.....#  #
#..##..##..# ##########......#    #.....#   #.....#   #.....#  #
#..##......#          #####..######.....#   #.....#   #.....#  #
#.##############################################################