#.##############################################################
#..................########### #.......#       #..........##...#
##############...............# #.......#       #..........# ##.#
#...##.....# #...............# #.......#  ######.########.#  #.#
##.###.....# #...............# #.......#  #......########.####.#
##.# #.....# #...............# #.......#  #......##....#.......#
##.#####.###################.######.#######......##....#.......#
##.##.........#       #...##.#    #..............##............#
##.##.........#       #.#.##.#    ######.##########....#.......#
##.##########.#       #.#.##.#     #####.####...###....#.......#
#.........# #.######  #.#.##.#######..........#.#####.#######.##
#.......#.# #......####.#..........######.###...#   #.##...##.##
#.......#.# #.####......#######............##########.##...##.##
#########.# #.#  #####################.....#..........##......##
#.........# #.#     #........##......#.....#......######...#####
#.###########.#######.#########......#.....#......#........# #.#
#.#  #................#  #...##......#######......#........###.#
#.###################.#  ###.##...................#............#
#.....................#    #.##......#######.###################
#.#####################    #.###############.###....##....##...#
#.#...............#        #.................###.##.##.##.##.#.#
#.#.##########.#############################.....##....##....#.#
#.#.#...##.....########..................#####################.#
#.#.#.#.##...........##..................##....................#
#.#...#.##.....#####.##..................##....................#
#.####..########   #.##..................##......####.##########
#.#  #.##....###   #.##..................##......#  #.#  #....##
#.#  #....##.#######.##..................##......####.####....##
#.##########.##......##..................##########...........##
#............####..####..................# #......#.######....##
#################..#  #..................# #.#....#.############
#.....##......###..############$############.#....#...........##
#.....##.####.###.............#.##....#  #...################.##
#.....##.####.#################.##.#..####.####............##.##
#..................................#............##########....##
################################################################
