################################################################
#...........#       #.................#          #..####.......#
#...........#       #.#...............#          #.............#
#...........######  #.###########.######################........
#................#  #.#     #..................................#
#...........####.####.#     ###########.......##########.......#
########.#######......#               #.......#        #########
#......#.############.#               #.......#                #
###.####.############.##########      #.......#                #
# #............................#      ####.####                #
################...............###########....##################
#................................................########......#
################................##############....#######......#
#     #.........................#            ##.....######.#####
#     ####.#####...............##             ##.............###
#  #######.#   ######.##########              ######.........###
####.......#        #.########################     #.........###
#....#######    #####.##   #.................#     ########.####
####.#          #......#   #####.##########..##############.####
#  #.####       #......#  ######.#        #....................#
####....#       #......#  #......#        #########............#
#.......###################...###                 #............#
#...............#         #...#                   #............#
#............####         ##.#######              #............#
#............#             #.......#              #.##########.#
#.......####.#             #######.########       #............#
#########  #.###########    ####..........#       #########.####
#......#   #...........#    #............#                #.#  #
###.########.#####.....#    ####........#            ######.#  #
#............#####....##       ######...#########    #......#  #
#####.#################          #..............###########.#  #
#   #............#               #..............#         #.#  #
#####.############               #..............#         #.#  #
#...#.########                   #..............#         ###  #
#............#                   #..............#              #
################################################################