 ########    #.###############
 #......###  #.##............#
#######...#  #.##.##.#####...#
#######.###  #....##.##.##...#
#.........#  #######....##...#
#..######.################.#.#
#..#    #.......#        #.#.#
#..#    #.#####.#        #.#.#
#..#    #.#.# #.#    #####.#.#
#..#    #.#.###.#    #.....#.#
#..#    #.#.....#    ##.####.#
#..#    #.#############.##...#
#..#    #...............##...#
##.#    ###########.######...#
 #.#########........#    ###.#
 #.# ################### ###.#
 #.###.................# #...#
 #.....................# #.###
 #####.................# #...#
     #################.# #####
                              
                              
                              