##############.###############
##......###  #.##............#
#######...#  #.##.##.#####...#
#######.###  #....##.##.##...#
#.........#  #######....##...#
#..######.################.#.#
#..#    #.......#        #.#.#
#..#    #.#####.#        #.#.#
#..#    #.#.# #.#    #####.#.#
#..#    #.#.###.#    #.....#.#
#..#    #.#.....#    ##.####.#
#..#    #.#############.##...#
#..#    #...............##...#
##.#    ###########.######...#
##.#########........#    ###.#
##.# ################### ###.#
##.###.................# #...#
##.....................# #.###
######.................# #...#
######################.#######
                              
                              
                              